GGGGGGGGGGGGGGGGGGGG
GGGGGGGGGGGGGGGGGGGG
GGGGGGGGGGGGGGGGGGGG
GGGWWWWWGGWWWGGGGGGG
GGWWGGGWWWWSWGGGGGGG
GGWPGBGBSGGGWGGGGGGG
GGWWWWWWWWGGWGGGGGGG
GGGGGGGGGWWWWGGGGGGG
GGGGGGGGGGGGGGGGGGGG
GGGGGGGGGGGGGGGGGGGG
GGGGGGGGGGGGGGGGGGGG
GGGGGGGGGGGGGGGGGGGG
