GGGGGGGGGGGGGGGGGGGG
GGGGGGGGGGGGGGGGGGGG
GGGGGGGGGGGGGGGGGGGG
GGGWWWWWWWGGGGGGGGGG
GGGWGBSBGWGGGGGGGGGG
GGWWGGBSGWGGGGGGGGGG
GGWSPBSBGWGGGGGGGGGG
GGWGGGBSGWGGGGGGGGGG
GGGWGBSBGWGGGGGGGGGG
GGGWGGBSGWGGGGGGGGGG
GGGWWWWWWGGGGGGGGGGG
GGGGGGGGGGGGGGGGGGGG
