GGGGGGGGGWWWWGGGGGGG
GGGGGGGGGWSWGWGGGGGG
GGGGWWWWWWGWGGGGGGGG
GGGGWGGWGWGWWWWGGGGG
GGGGWGGWGGBSGGWGGGGG
GGGGWPGGGWGWBGWGGGGG
GGGGWGGGGGGGGGWGGGGG
GGGGWGGGGGWGGWWGGGGG
GGGGWWWWWWWWWWGGGGGG
GGGGGGGGGGGGGGGGGGGG
GGGGGGGGGGGGGGGGGGGG
GGGGGGGGGGGGGGGGGGGG
