GGGGGGGGGGGGGGGGGGGG
GGGGGGGGGGGGGGGGGGGG
GGGGGGGWWWWGWWWWGGGG
GGGGWWWWGGWGWGSWGGGG
GGGGWGGGGBWWWGGWGGGG
GGGGWPGGBGGGGGSWGGGG
GGGGWGGGGBWWWGGWGGGG
GGGGWWWWGGWGWGSWGGGG
GGGGGGGWWWWGWWWWGGGG
GGGGGGGGGGGGGGGGGGGG
GGGGGGGGGGGGGGGGGGGG
GGGGGGGGGGGGGGGGGGGG
