GGGGGGGGGGWWWWGGGGGG
GGGWWWWWWWWGGWWGGGGG
GGGWGGGGGGGGGGWGGGGG
GGGWGGGGGWGGSGWGGGGG
GGGWGGGBGGWGGSWGGGGG
GGGWPGBBBGWGWSWGGGGG
GGGWGGGBGGWGGSWGGGGG
GGGWGGGGGWGGSGWGGGGG
GGGWGGGGGGGGGGWGGGGG
GGGWWWWWWWWGGWWGGGGG
GGGGGGGGGGWWWGGGGGGG
GGGGGGGGGGGGGGGGGGGG
