GGGGGGGGGGGGGGGGGGGG
GGGGGGGGGGGGGGGGGGGG
GGGGWWWGGGGGGGGGGGGG
GGGGWSWGWWWWWGGGGGGG
WWWWGBGWWGGGWGGGGGGG
WPGGBGBSGGBBWGGGGGGG
WGGGGBSWWGGSWGGGGGGG
WWWWWWWGWWWWWGGGGGGG
GGGGGGGGGGGGGGGGGGGG
GGGGGGGGGGGGGGGGGGGG
GGGGGGGGGGGGGGGGGGGG
GGGGGGGGGGGGGGGGGGGG
