GGGGGGGGGGGGGGGGGGGG
GWWWWWWWWWWWWWWWWWWG
GWGGGGGGGGGGGGGGGGWG
GWGGGGGGGSGGGGGGGGWG
GWGGGGGBGBBSGGGGGGWG
GWPGGGGBBBSSSGGGGGWG
GWGGGGGSBSBSGGGGGGWG
GWGGGGGGGGGGGGGGGGWG
GWGGGGGGGGGGGGGGGGWG
GWGGGGGGGGGGGGGGGGWG
GWWWWWWWWWWWWWWWWWWG
GGGGGGGGGGGGGGGGGGGG
