GGGGGGGGGGGGGGGGGGGG
GGGGGGGGGGGGGGGGGGGG
GGGGGWWWWWWGWWWGGGGG
GWWWWWGGGGWGWSWWWWGG
WWGSBWGWWGWWWGBGSWGG
WPGBGGGWWGGGGBGBWWGG
WWGGBWGWWGWWSGBGWGGG
GWWWWWGGBSWWWWWSWGGG
GGGGGWWWWWWGGGWWWGGG
GGGGGGGGGGGGGGGGGGGG
GGGGGGGGGGGGGGGGGGGG
GGGGGGGGGGGGGGGGGGGG
