GWWWWWWWWWWWWWGGGGGG
WWGGGSWWSGGGSWGGGGGG
WSGGBGWWGWGBGWGGGGGG
WBWBGGGGBGBWGWGGGGGG
WPGGBGWWGGGBGWGGGGGG
WSGGWSWWSGWGSWGGGGGG
WWWWWWWWWWWWWWGGGGGG
GGGGGGGGGGGGGGGGGGGG
GGGGGGGGGGGGGGGGGGGG
GGGGGGGGGGGGGGGGGGGG
GGGGGGGGGGGGGGGGGGGG
GGGGGGGGGGGGGGGGGGGG
