GGGGGGGGGGGGGGGGGGGG
GGGGGGGGGGGGGGGGGGGG
GGGGGGGGGGGGGGGGGGGG
GGGGGGGGGGGGGGGGGGGG
GGGWWWWWWGGGGGGGGGGG
GGGWPGBSWGGGGGGGGGGG
GGGWWWWWWGGGGGGGGGGG
GGGGGGGGGGGGGGGGGGGG
GGGGGGGGGGGGGGGGGGGG
GGGGGGGGGGGGGGGGGGGG
GGGGGGGGGGGGGGGGGGGG
GGGGGGGGGGGGGGGGGGGG
